01110110
00010001
01011011
11000010
10011010
11001011
11111010
00111100